NO ./sa0.png
SO ./sa1.png
WE ./sa2.png
EA ./sa3.png

F 225,30,0
C 200,200,200


        11111111111111111111111111111111111111
        10000000001100000000000000000000000001
        10110000011100000111000011111111111101
        1001000000000000010000001          101
111111111011000001110000010000001          101
100000000011000001110111111111111          101
11110111111111011100000000001              101
11110111111111011101010010001              101
11000000110101011100000010001              101
1000000000000000110000001000111111111111111101
1000000000000000110101001000000000000000000001
11000001110101011111011110N0111111111111111111
11110111 1110101 101111010001
11110111 1111111 111111111111
100000001000000010000000000001
111111000011111000110111111111
111111011111111111110000000001
111110011111111111100001111101
111111011111111111101111111111
111111000000000000001111111111
11111111111111111111