111111111111111111111111111 
10000000000000000000000000111111111111 
      11011111101001111100010000000000000001 
11111111001001000000010000111111111101 
        110100111110010011101111001101 
10011000000001001010000100000000000001 
 100000000111110010110001001        101 
11011111000000001000011100111111111101 
  10010000000000001001110000000000000001           
11111111111111111111111111111111111111   
