1111111111111111111111111
1101001001110000000000001
10N0000001110101010101001
1000100000000000000000001
1111111111110101011101001
1000000000110000011101111
1111011111111101110000001
1111011111111101110101001
1101000011010101110000001
10000N0000000000110101001
1001000100000000110101001
1100000111010101111101111
11110111 1110101 10111101
1111111111111111111111111