11111111
10010001
10000101
1110N011
11111111