1111111111111111111
10N00000000111
10111110111111111
1011111111
1111