NO ./path_to_the_north_texture
SO ./path_to_the_south_texture
WE ./path_to_the_south_texture
EA ./path_to_the_east_text
F 164,169,20
C 153,204,255

111111111111111111111111111111111111111111111111
100000000000000000000000000000000000000000000001
100000000000000000000000000000000000000000000001
100000000000000000000000000000000000000000000001
100000000000000000000000000000000000000000000001
100000000000000000000000000000000000000000000001
100000000000000001111110000000000000000111100011
100000000000000000000000000000000000000000000001
10000000000000000000000N000000000000000000000001
100000000000000000000000000000000000000000000001
100000000000000001111110000000000000000111100011
100000000000000000000000000000000000000000000001
100000000000000001111110000000000000000111100011
100000000000000000000000000000000000000000000001
100000000000000000000000000000000000000000000001
111111111111111111111111111111111111111111111111