NO ./mandatory/assets/sa0.png
SO ./mandatory/assets/sa1.png
WE ./mandatory/assets/sa2.png
EA ./mandatory/assets/sa3.png

F 220,100,0
C 225,30,0


 11111111111111111111111111111
1000000000000000000000000000001
1000000000000000000000000000001
1000000000000000000000000000001
1000000000000000000000000000001
1000000000000000001010000000001
1000000000000000001010000000001
1000000000000000000N00010000001
1000000000000000001110010000001
1000000000000000000000000000001
1000000000000000000100000000001
1000000000000000000000000000001
 11111111111111111111111111111