NO ./bonus/assets/sa0.png
SO ./bonus/assets/sa1.png
WE ./bonus/assets/sa2.png
EA ./bonus/assets/sa3.png

F 20,30,0
C 200,200,200

        11111111111111111111111111111111111111
        10000000001100000000000000000000000001
        10110000011100000111000011111111111101
        1001000000000000010000001          101
111111111011000001110000010000001          101
1000000000110000011101111111111001         101
11110111111 11011100000000001  100111111111101
11110111  1111011101010010001   10000000000001
11000000110101011100000010001    1001111111101
100000000000000011000000100011111110111111110111111
100000000000000011010100100000000000000000000000001
11000001110101011111011110N011111111111111111111101
  110111 1110101 101111010001                   101
 1110111 1111111 1111111111111111111111111111111101
1000000010000000100000000000000000000000011000000011111
11111100001111100011011011111111011111110100111110000001
      1011     111 101101      101      1001     1111101
      1001        101 101      1011111110011111111111101
       100111111110111101111111101111110000000000001 101
        100000000000000000000000000000000111110111011001
         1000000000000000000000000000000000000000000001
          11011111111110110111110101111111111111011111
          1100000000000011000000010000000000000001
           11111111111111111111111111111111111111